AIN - AIN
Afghanistan - AFG
Albania - ALB
Algeria - ALG
Andorra - AND
Angola - ANG
Antigua and Barbuda - ANT
Argentina - ARG
Armenia - ARM
Aruba - ARU
Australia - AUS
Austria - AUT
Azerbaijan - AZE
Bahamas - BAH
Bahrain - BRN
Bangladesh - BAN
Barbados - BAR
Belgium - BEL
Belize - BIZ
Benin - BEN
Bermuda - BER
Bhutan - BHU
Bolivia - BOL
Bosnia and Herzegovina - BIH
Botswana - BOT
Brazil - BRA
British Virgin Islands. - IVB
Brunei Darussalam - BRU
Bulgaria - BUL
Burkina Faso - BUR
Burundi - BDI
Cambodia - CAM
Cameroon - CMR
Canada - CAN
Cape Green - CPV
Cayman Islands - CAY
Central African Republic - CAF
Chad - CHA
Chile - CHI
China - CHN
Chinese Taipei - TPE
Colombia - COL
Comoros - COM
Congo - CGO
Cook Islands - COK
Costa Rica - CRC
Croatia - CRO
Cuba - CUB
Cyprus - CYP
Czechia - CZE
Côte d'Ivoire - CIV
DPR Korea - PRK
DR Congo - COD
Denmark - DEN
Djibouti - DJI
Dominica - DMA
Dominican Republic - DOM
EOR - EOR
East Timor - TLS
Ecuador - ECU
Egypt - EGY
El Salvador - ESA
Emir. United Arab Emirates - UAE
Equatorial Guinea - GEQ
Eritrea - ERI
Estonia - EST
Eswatini - SWZ
Ethiopia - ETH
Fiji - FIJ
Finland - FIN
France - FRA
Gabon - GAB
Gambia - GAM
Georgia - GEO
Germany - GER
Ghana - GHA
Great Britain - GBR
Greece - GRE
Grenade - GRN
Guam - GUM
Guatemala - GUA
Guinea - GUI
Guinea Bissau - GBS
Guyana - GUY
Haiti - HAI
Honduras - HON
Hong Kong, China - HKG
Hungary - HUN
Iceland - ISL
India - IND
Indonesia - INA
Iraq - IRQ
Ireland - IRL
Islamic Rep. of Iran - IRI
Israel - ISR
Italy - ITA
Jamaica - JAM
Japan - JPN
Jordan - JOR
Kazakhstan - KAZ
Kenya - KEN
Kiribati - KIR
Kosovo - KOS
Kuwait - KUW
Kyrgyzstan - KGZ
Laos - LAO
Latvia - LAT
Lebanon - LBN
Liberia - LBR
Libya - LBA
Liechtenstein - LIE
Lithuania - LTU
Luxembourg - LUX
Madagascar - MAD
Malawi - MAW
Malaysia - MAS
Maldives - MDV
Mali - MLI
Malta - MLT
Marshall Islands - MHL
Mauricio Islands - MRI
Mauritania - MTN
Mexico - MEX
Micronesia - FSM
Moldova - MDA
Monaco - MON
Mongolia - MGL
Montenegro - MNE
Morocco - MAR
Mozambique - MOZ
Myanmar - MYA
Namibia - NAM
Nauru - NRU
Nepal - NEP
Netherlands - NED
New Zealand - NZL
Nicaragua - NCA
Niger - NIG
Nigeria - NGR
Norway - NOR
Oman - OMA
Pakistan - PAK
Palau - PLW
Panama - PAN
Papua New Guinea - PNG
Paraguay - PAR
Peru - PER
Philippines - PHI
Poland - POL
Portugal - POR
Puerto Rico - PUR
Qatar - QAT
Republic of Korea - KOR
Romania - ROU
Rwanda - RWA
S. Vicen. and Granadi. - VIN
Saint Lucia - LCA
Samoa - SAM
San Marino - SMR
Sao Tome and Principe - STP
Saudi Arabia - KSA
Senegal - SEN
Serbia - SRB
Seychelles - SEY
Sierra Leone - SLE
Singapore - SGP
Slovakia - SVK
Slovenia - SLO
Solomon Islands - SOL
Somalia - SOM
South Africa - RSA
Southern Sudan - SSD
Spain - ESP
Sri Lanka - SRI
St. Kitts and Nevis - SKN
State of Palestine - PLE
Sudan - SUD
Suriname - SUR
Sweden - SWE
Switzerland - SUI
Syrian Arab Rep. - SYR
Tajikistan - TJK
Tanzania - TAN
Thailand - THA
Togo - TOG
Tonga - TGA
Trinidad and Tobago - TTO
Tunisia - TUN
Turkey - TUR
Turkmenistan - TKM
Tuvalu - TUV
US Virgin Islands - ISV
USA - USA
Uganda - UGA
Ukraine - UKR
Uruguay - URU
Uzbekistan - UZB
Vanuatu - VAN
Venezuela - VEN
Vietnam - VIE
Yemen - YEM
Zambia - ZAM
Zimbabwe - ZIM
